50
156
08 08 08 08 08 08 08 08 08 08 08 08 08 08 08 08 08 08 08 08 08 08 08 08 08 08 08 08 08 08 08 08 08 08 08 08 08 08 08 08 08 08 08 08 08 08 08 08 08 08 08 08 08 08 08 08 08 08 08 08 08 08 08 08 08 08 08 08 08 08 08 08 08 08 08 08 08 08 08 08 08 08 08 08 08 08 08 08 08 08 08 08 08 08 08 08 08 08 08 08 08 08 08 08 08 08 08 08 08 08 08 08 08 08 08 08 08 08 08 08 08 08 08 08 08 08 08 08 08 08 08 08 08 08 08 08 08 08 08 08 08 08 08 08 08 08 08 08 08 08 08 08 08 08 08 08
08 08 08 08 08 08 08 08 08 08 08 08 08 08 08 08 08 08 08 08 08 08 08 08 08 08 08 08 08 08 08 08 08 08 08 08 08 08 08 08 08 08 08 08 08 08 08 08 08 08 08 08 08 08 08 08 08 08 08 08 08 08 08 08 08 08 08 08 08 08 08 08 08 08 08 08 08 08 08 08 08 08 08 08 08 08 08 08 08 08 08 08 08 08 08 08 08 08 08 08 08 08 08 08 08 08 08 08 08 08 08 08 08 08 08 08 08 08 08 08 08 08 08 08 08 08 08 08 08 08 08 08 08 08 08 08 08 08 08 08 08 08 08 08 08 08 08 08 08 08 08 08 08 08 08 08
08 08 08 08 08 08 08 08 08 08 08 08 08 08 08 08 08 08 08 08 08 08 08 08 08 08 08 08 08 08 08 08 08 08 08 08 08 08 08 08 08 08 08 08 08 08 08 08 08 08 08 08 08 08 08 08 08 08 08 08 08 08 08 08 08 08 08 08 08 08 08 08 08 08 08 08 08 08 08 08 08 08 08 08 08 08 08 08 08 08 08 08 08 08 08 08 08 08 08 08 08 08 08 08 08 08 08 08 08 08 08 08 08 08 08 08 08 08 08 08 08 08 08 08 08 08 08 08 08 08 08 08 08 08 08 08 08 08 08 08 08 08 08 08 08 08 08 08 08 08 08 08 08 08 08 08
08 08 08 08 08 08 08 08 08 08 08 08 08 08 08 08 08 08 08 08 08 08 08 08 08 08 08 08 08 08 08 08 08 08 08 08 08 08 08 08 08 08 08 08 08 08 08 08 08 08 08 08 08 08 08 08 08 08 08 08 08 08 08 08 08 08 08 08 08 08 08 08 08 08 08 08 08 08 08 08 08 08 08 08 08 08 08 08 08 08 08 08 08 08 08 08 08 08 08 08 08 08 08 08 08 08 08 08 08 08 08 08 08 08 08 08 08 08 08 08 08 08 08 08 08 08 08 08 08 08 08 08 08 08 08 08 08 08 08 08 08 08 08 08 08 08 08 08 08 08 08 08 08 08 08 08
08 08 08 09 10 11 12 11 12 11 12 11 12 11 12 11 12 11 12 11 12 11 12 11 12 11 12 11 12 11 12 11 12 11 12 11 12 11 12 11 12 11 12 11 12 11 12 11 12 11 12 11 12 11 12 11 12 11 12 11 12 11 12 11 12 11 12 11 12 11 12 11 12 11 12 11 12 11 12 11 12 11 12 11 12 11 12 11 12 11 12 11 12 11 12 11 12 11 12 11 12 11 12 11 12 11 12 11 12 11 12 11 12 11 12 11 12 11 12 11 12 11 12 11 12 11 12 11 12 11 12 11 12 11 12 11 12 11 12 11 12 11 12 11 12 11 12 11 12 11 12 11 12 11 12 11
08 08 08 09 13 13 13 13 13 13 13 13 13 13 13 13 13 13 13 13 13 13 13 13 13 13 13 13 13 13 13 13 13 13 13 13 13 13 13 13 13 13 13 13 13 13 13 13 13 13 13 13 13 13 13 13 13 13 13 13 13 13 13 13 13 13 13 13 13 13 13 13 13 13 13 13 13 13 13 13 13 13 13 13 13 13 13 13 13 13 13 13 13 13 13 13 13 13 13 13 13 13 13 13 13 13 13 13 13 13 13 13 13 13 13 13 13 13 13 15 17 13 13 13 13 13 13 13 13 13 13 13 13 13 13 13 13 13 13 13 13 13 13 13 13 13 13 13 13 13 13 13 07 08 08 08
08 08 08 09 14 14 14 14 14 46 14 14 46 14 14 42 14 14 14 14 14 14 14 14 14 14 14 46 14 14 46 14 14 14 14 14 14 14 14 14 14 14 14 14 14 46 14 14 46 15 17 14 14 14 14 14 14 14 14 14 14 14 14 46 14 14 46 14 14 14 14 14 14 42 14 14 14 14 14 14 14 46 14 14 46 14 14 14 14 14 14 14 14 14 14 14 14 14 14 46 14 14 46 14 14 14 14 14 14 14 14 14 14 14 14 14 14 46 14 15 17 14 14 14 14 14 14 42 14 14 14 14 14 14 14 14 14 14 14 14 42 14 14 14 14 14 14 14 14 14 14 14 07 08 08 08
08 08 08 09 14 14 14 14 14 46 14 14 46 14 14 43 14 14 14 14 14 14 14 14 14 14 14 46 14 14 46 14 14 14 42 14 14 14 14 14 14 14 14 14 14 46 14 14 46 15 17 14 14 14 14 14 14 14 14 14 14 14 14 46 14 14 46 14 14 14 14 14 14 43 14 14 14 14 14 14 14 46 14 14 46 14 14 14 14 14 14 14 14 14 14 14 14 14 14 46 14 14 46 14 14 14 14 14 14 14 14 14 14 14 14 14 14 46 14 15 17 14 14 14 14 14 14 43 14 14 14 14 14 14 14 14 14 14 14 14 43 14 14 14 14 14 14 14 14 14 14 14 07 08 08 08
10 08 08 09 14 14 14 14 14 45 14 14 45 14 14 44 14 14 14 14 14 14 14 14 14 14 14 45 14 14 45 14 14 14 43 14 14 14 14 14 14 14 14 14 14 45 14 14 45 15 17 14 14 14 14 14 14 14 14 14 14 14 14 45 14 14 45 14 14 14 14 14 14 44 14 14 14 14 14 14 14 45 14 14 45 14 14 14 14 14 14 14 14 14 14 14 14 14 14 45 14 14 45 14 14 14 14 14 14 14 14 14 14 14 14 14 14 45 14 15 17 14 14 14 14 14 14 44 14 14 14 14 14 14 14 14 14 14 14 14 44 14 14 14 14 14 14 14 14 14 14 14 07 08 08 08
08 11 08 09 14 14 14 14 14 46 14 14 46 14 14 14 14 14 14 14 14 14 42 14 14 14 14 46 14 14 46 14 14 14 44 14 14 14 14 14 14 14 14 14 14 46 14 14 46 15 17 14 14 14 14 14 42 14 14 14 14 14 14 46 14 14 46 14 14 14 14 14 14 14 14 14 14 14 14 14 14 46 14 14 46 14 14 14 14 14 14 14 14 14 14 14 14 14 14 46 14 14 46 14 14 14 14 14 14 14 14 14 14 14 14 14 14 46 14 15 17 14 14 14 14 14 14 14 14 14 14 14 14 14 14 14 14 14 14 14 14 14 14 14 14 14 14 14 14 14 14 14 07 08 08 08
13 08 12 09 14 14 14 14 18 19 20 21 22 23 14 14 14 14 14 14 14 14 43 14 14 14 18 19 20 21 22 23 14 14 14 14 14 14 14 14 14 14 14 14 18 19 20 21 22 15 17 14 14 14 14 14 43 14 14 14 14 14 18 19 20 21 22 23 14 14 14 14 14 14 14 14 14 14 14 14 18 19 20 21 22 23 14 14 14 14 42 14 14 14 14 14 14 14 18 19 20 21 22 23 14 14 14 14 14 14 14 14 14 14 14 14 18 19 20 15 17 14 14 14 14 14 14 14 14 14 14 14 14 14 14 14 14 14 14 14 14 14 14 14 14 14 14 14 14 14 14 14 07 08 08 08 
08 14 08 09 14 14 14 14 24 25 26 27 28 29 14 14 14 14 14 14 14 14 44 14 14 14 24 25 26 27 28 29 14 14 14 14 14 14 14 14 14 14 14 14 24 25 26 27 28 15 17 14 14 14 14 14 44 14 14 14 14 14 24 25 26 27 28 29 14 14 14 14 14 14 14 14 14 14 14 14 24 25 26 27 28 29 14 14 14 14 43 14 14 14 14 14 14 14 24 25 26 27 28 29 14 14 14 14 14 14 14 14 14 14 14 14 24 25 26 15 17 14 14 14 14 14 14 14 14 14 14 14 14 14 14 14 14 14 14 14 14 14 14 14 14 14 14 14 14 14 14 14 07 08 08 08 
08 08 15 09 14 14 14 14 30 31 32 33 34 35 14 14 14 14 14 14 14 14 14 14 14 14 30 31 32 33 34 35 14 14 14 14 14 14 14 14 14 14 14 14 30 31 32 33 34 15 17 14 14 14 14 14 14 14 14 14 14 14 30 31 32 33 34 35 14 14 14 14 14 14 14 14 14 14 14 14 30 31 32 33 34 35 14 14 14 14 44 14 14 14 14 14 14 14 30 31 32 33 34 35 14 14 14 14 14 14 14 14 14 14 14 14 30 31 32 15 17 14 14 14 14 14 14 14 14 14 14 14 14 14 14 14 14 14 14 14 14 14 14 14 14 14 14 14 14 14 14 14 07 08 08 08
16 08 08 09 14 14 14 14 36 37 38 39 40 41 14 14 14 14 14 14 14 14 14 14 14 14 36 37 38 39 40 41 14 14 14 14 14 14 14 14 42 14 14 14 36 37 38 39 40 15 17 14 14 14 14 14 14 14 14 14 14 14 36 37 38 39 40 41 14 14 14 14 14 14 14 14 14 14 14 14 36 37 38 39 40 41 14 14 14 14 14 14 14 14 14 14 14 14 36 37 38 39 40 41 14 14 14 14 14 14 14 14 14 14 14 14 36 37 38 15 17 14 14 14 14 14 14 14 14 14 14 14 14 14 14 14 14 14 14 14 14 14 14 14 42 14 14 14 14 14 14 14 07 08 08 08 
08 17 08 09 14 14 14 14 14 46 14 14 46 14 14 14 14 14 14 14 14 14 14 14 14 14 14 46 14 14 46 14 14 14 14 14 14 14 14 14 43 14 14 14 14 46 14 14 46 15 17 14 14 14 14 14 14 14 14 14 14 14 14 46 14 14 46 14 14 14 14 14 14 14 14 14 14 14 14 14 14 46 14 14 46 14 14 14 14 14 14 14 14 14 14 14 14 14 14 46 14 14 46 14 14 14 14 14 14 14 14 42 14 14 14 14 14 46 14 14 47 14 14 14 14 14 14 14 14 14 14 14 14 14 14 14 14 14 14 14 14 14 14 14 43 14 14 14 14 14 14 14 07 08 08 08 
08 08 18 09 14 14 14 14 14 45 14 14 45 14 14 14 14 14 14 14 14 14 14 14 14 14 14 45 14 14 45 14 14 14 14 14 49 02 02 02 02 02 03 14 14 45 14 14 45 15 17 14 14 14 14 14 14 14 14 14 14 14 14 45 14 14 45 14 14 14 14 14 14 14 14 14 14 14 14 14 14 45 14 14 45 14 14 14 14 14 14 14 14 14 14 14 14 14 14 45 14 14 45 14 14 14 14 14 14 14 14 43 14 14 14 14 14 45 14 14 48 14 14 14 14 14 14 14 14 14 14 14 14 14 14 14 14 14 14 14 14 14 14 14 44 14 14 14 14 14 14 14 07 08 08 08
08 08 08 09 14 14 14 14 14 46 14 14 46 14 14 14 14 49 02 02 02 02 02 03 14 14 14 46 14 14 46 14 14 14 14 14 50 05 05 05 05 05 06 14 14 46 14 14 46 15 17 14 14 14 14 14 14 14 14 14 14 14 14 46 14 14 46 14 14 14 14 14 14 14 14 14 14 14 14 14 14 46 14 14 46 14 14 14 14 14 14 14 14 14 14 14 14 14 14 46 14 14 46 14 14 14 14 14 14 14 14 44 14 14 14 14 14 46 14 14 47 14 14 14 14 14 14 14 14 14 14 14 14 14 14 14 14 14 14 14 14 14 14 14 14 14 14 14 14 14 14 14 07 08 08 08
08 08 08 09 14 14 14 14 14 46 14 14 46 14 14 14 14 50 05 05 05 05 05 06 14 14 14 46 14 14 46 14 14 14 14 14 07 08 08 08 08 08 09 14 14 46 14 14 46 15 17 49 02 02 02 02 02 02 02 02 02 02 02 02 02 02 02 02 02 02 02 03 14 14 14 14 14 14 14 14 14 46 14 14 46 14 14 14 14 14 14 14 14 14 14 14 14 14 14 46 14 14 46 14 14 14 14 14 14 14 14 14 14 14 14 14 14 46 14 14 48 14 14 14 14 14 14 14 14 14 14 14 14 14 14 14 14 14 14 14 14 14 14 14 14 14 14 14 14 14 14 14 07 08 08 08
08 08 08 08 05 05 05 05 05 05 05 05 05 05 05 05 05 08 08 08 08 08 08 09 14 14 14 46 14 14 46 14 14 14 14 14 07 08 08 08 08 08 08 05 05 05 05 05 05 05 05 05 05 05 05 05 05 05 05 05 05 05 05 05 05 05 05 05 05 05 05 09 14 14 14 14 14 14 14 49 05 05 05 05 05 05 05 05 05 05 05 05 05 05 05 05 05 05 05 05 05 05 05 05 05 05 05 05 05 05 05 05 05 05 05 05 05 05 05 05 05 05 05 05 05 05 05 05 05 05 05 05 05 05 05 05 05 05 05 05 05 05 05 05 05 05 05 05 05 05 05 05 08 08 08 08 
08 08 08 08 08 08 08 08 08 08 08 08 08 08 08 08 08 08 08 08 08 08 08 09 14 14 14 46 14 14 46 14 14 14 14 14 07 08 08 08 08 08 08 08 08 08 08 08 08 08 08 08 08 08 08 08 08 08 08 08 08 08 08 08 08 08 08 08 08 08 08 09 14 14 14 14 14 14 14 07 08 08 08 08 08 08 08 08 08 08 08 08 08 08 08 08 08 08 08 08 08 08 08 08 08 08 08 08 08 08 08 08 08 08 08 08 08 08 08 08 08 08 08 08 08 08 08 08 08 08 08 08 08 08 08 08 08 08 08 08 08 08 08 08 08 08 08 08 08 08 08 08 08 08 08 08
08 08 08 08 08 08 08 08 08 08 08 08 08 08 08 08 08 08 08 08 08 08 08 09 14 14 14 46 14 14 46 14 14 14 14 14 07 08 08 08 08 08 08 08 08 08 08 08 08 08 08 08 08 08 08 08 08 08 08 08 08 08 08 08 08 08 08 08 08 08 08 09 14 14 14 14 14 14 14 07 08 08 08 08 08 08 08 08 08 08 08 08 08 08 08 08 08 08 08 08 08 08 08 08 08 08 08 08 08 08 08 08 08 08 08 08 08 08 08 08 08 08 08 08 08 08 08 08 08 08 08 08 08 08 08 08 08 08 08 08 08 08 08 08 08 08 08 08 08 08 08 08 08 08 08 08   
08 08 08 08 08 08 08 08 08 08 08 08 08 08 08 08 08 08 08 08 08 08 08 09 14 14 14 46 14 14 46 14 14 14 14 14 07 08 08 08 08 08 08 08 08 08 08 08 08 08 08 08 08 08 08 08 08 08 08 08 08 08 08 08 08 08 08 08 08 08 08 09 14 14 14 14 14 14 14 07 08 08 08 08 08 08 08 08 08 08 08 08 08 08 08 08 08 08 08 08 08 08 08 08 08 08 08 08 08 08 08 08 08 08 08 08 08 08 08 08 08 08 08 08 08 08 08 08 08 08 08 08 08 08 08 08 08 08 08 08 08 08 08 08 08 08 08 08 08 08 08 08 08 08 08 08
08 08 08 08 08 08 08 08 08 08 08 08 08 08 08 08 08 08 08 08 08 08 08 09 14 14 14 46 14 14 46 14 14 14 14 14 07 08 08 08 08 08 08 08 08 08 08 08 08 08 08 08 08 08 08 08 08 08 08 08 08 08 08 08 08 08 08 08 08 08 08 09 14 14 14 14 14 14 14 07 08 08 08 08 08 08 08 08 08 08 08 08 08 08 08 08 08 08 08 08 08 08 08 08 08 08 08 08 08 08 08 08 08 08 08 08 08 08 08 08 08 08 08 08 08 08 08 08 08 08 08 08 08 08 08 08 08 08 08 08 08 08 08 08 08 08 08 08 08 08 08 08 08 08 08 08
08 08 08 08 08 08 08 08 08 08 08 08 08 08 08 08 08 08 08 08 08 08 08 09 14 14 14 46 14 14 46 14 14 14 14 14 07 08 08 08 08 08 08 08 08 08 08 08 08 08 08 08 08 08 08 08 08 08 08 08 08 08 08 08 08 08 08 08 08 08 08 09 14 14 14 14 14 14 14 07 08 08 08 08 08 08 08 08 08 08 08 08 08 08 08 08 08 08 08 08 08 08 08 08 08 08 08 08 08 08 08 08 08 08 08 08 08 08 08 08 08 08 08 08 08 08 08 08 08 08 08 08 08 08 08 08 08 08 08 08 08 08 08 08 08 08 08 08 08 08 08 08 08 08 08 08
08 08 08 08 08 08 08 08 08 08 08 08 08 08 08 08 08 08 08 08 08 08 08 09 14 14 14 46 02 02 02 02 02 02 02 02 07 08 08 08 08 08 08 08 08 08 08 08 08 08 08 08 08 08 08 08 08 08 08 08 08 08 08 08 08 08 08 08 08 08 08 09 14 14 14 14 14 14 14 07 08 08 08 08 08 08 08 08 08 08 08 08 08 08 08 08 08 08 08 08 08 08 08 08 08 08 08 08 08 08 08 08 08 08 08 08 08 08 08 08 08 08 08 08 08 08 08 08 08 08 08 08 08 08 08 08 08 08 08 08 08 08 08 08 08 08 08 08 08 08 08 08 08 08 08 08
08 08 08 08 08 08 08 08 08 08 08 08 08 08 08 08 08 08 08 08 08 08 08 09 14 14 14 46 14 14 46 14 14 14 14 14 07 08 08 08 08 08 08 08 08 08 08 08 08 08 08 08 08 08 08 08 08 08 08 08 08 08 08 08 08 08 08 08 08 08 08 09 14 14 14 14 14 14 14 07 08 08 08 08 08 08 08 08 08 08 08 08 08 08 08 08 08 08 08 08 08 08 08 08 08 08 08 08 08 08 08 08 08 08 08 08 08 08 08 08 08 08 08 08 08 08 08 08 08 08 08 08 08 08 08 08 08 08 08 08 08 08 08 08 08 08 08 08 08 08 08 08 08 08 08 08
08 08 08 08 08 08 08 08 08 08 08 08 08 08 08 08 08 08 08 08 08 08 08 09 14 14 14 46 14 14 46 14 14 14 14 14 07 08 08 08 08 08 08 08 08 08 08 08 08 08 08 08 08 08 08 08 08 08 08 08 08 08 08 08 08 08 08 08 08 08 08 09 14 14 14 14 14 14 14 07 08 08 08 08 08 08 08 08 08 08 08 08 08 08 08 08 08 08 08 08 08 08 08 08 08 08 08 08 08 08 08 08 08 08 08 08 08 08 08 08 08 08 08 08 08 08 08 08 08 08 08 08 08 08 08 08 08 08 08 08 08 08 08 08 08 08 08 08 08 08 08 08 08 08 08 08
08 08 08 08 08 08 08 08 08 08 08 08 08 08 08 08 08 08 08 08 08 08 08 09 14 14 14 46 14 14 46 14 14 14 14 14 07 08 08 08 08 08 08 08 08 08 08 08 08 08 08 08 08 08 08 08 08 08 08 08 08 08 08 08 08 08 08 08 08 08 08 09 14 14 14 14 14 14 14 07 08 08 08 08 08 08 08 08 08 08 08 08 08 08 08 08 08 08 08 08 08 08 08 08 08 08 08 08 08 08 08 08 08 08 08 08 08 08 08 08 08 08 08 08 08 08 08 08 08 08 08 08 08 08 08 08 08 08 08 08 08 08 08 08 08 08 08 08 08 08 08 08 08 08 08 08
08 08 08 08 08 08 08 08 08 08 08 08 08 08 08 08 08 08 08 08 08 08 08 09 14 14 14 46 14 14 46 14 14 14 14 14 07 08 08 08 08 08 08 08 08 08 08 08 08 08 08 08 08 08 08 08 08 08 08 08 08 08 08 08 08 08 08 08 08 08 08 09 14 14 14 14 14 14 14 07 08 08 08 08 08 08 08 08 08 08 08 08 08 08 08 08 08 08 08 08 08 08 08 08 08 08 08 08 08 08 08 08 08 08 08 08 08 08 08 08 08 08 08 08 08 08 08 08 08 08 08 08 08 08 08 08 08 08 08 08 08 08 08 08 08 08 08 08 08 08 08 08 08 08 08 08
11 12 11 12 08 08 08 08 08 08 08 08 08 08 09 11 12 11 12 11 12 11 12 09 14 14 14 46 14 14 46 14 14 14 14 14 07 11 12 11 12 11 12 11 12 11 12 11 12 11 12 11 12 11 12 11 12 11 12 11 12 11 12 11 12 11 12 11 12 11 12 11 14 14 14 14 14 14 14 07 08 08 08 08 08 08 08 08 08 08 08 08 08 08 08 08 08 08 08 08 08 08 12 11 12 11 12 11 12 11 12 11 12 11 12 11 12 11 12 11 12 11 12 11 12 11 12 11 12 11 12 11 12 11 12 11 12 11 12 11 12 11 12 11 12 11 12 11 12 11 12 11 12 11 12 11
08 08 08 09 08 08 08 08 08 08 08 08 08 08 09 13 13 13 13 13 13 13 13 13 14 14 14 46 14 14 46 14 14 14 14 14 13 13 13 13 13 13 13 13 13 13 13 13 13 13 13 13 13 13 13 13 13 13 13 13 13 13 13 13 13 13 13 13 13 13 13 13 14 14 14 14 14 14 14 07 08 08 08 08 08 08 08 08 08 08 08 08 08 08 08 08 08 08 08 08 08 08 13 13 13 13 13 13 13 13 13 13 13 13 13 13 13 13 13 15 17 13 13 13 13 13 13 13 13 13 13 13 13 13 13 13 13 13 13 13 13 13 13 13 13 13 13 13 13 13 13 13 07 08 08 08
08 08 08 09 08 08 08 08 08 08 08 08 08 08 09 14 14 14 14 14 14 14 14 14 14 14 14 46 14 14 46 14 14 14 14 14 14 14 14 14 14 14 14 14 14 46 14 14 46 14 14 14 14 14 14 14 14 14 14 14 14 14 14 46 14 14 46 14 14 14 14 14 14 42 14 14 14 14 14 07 08 08 08 08 08 08 08 08 08 08 08 08 08 08 08 08 08 08 08 08 08 08 46 14 14 14 14 14 14 14 14 14 14 14 14 14 14 46 14 15 17 14 14 14 14 14 14 42 14 14 14 14 14 14 14 14 14 14 14 14 42 14 14 14 14 14 14 14 14 14 14 14 07 08 08 08
08 08 08 09 08 08 08 08 08 08 08 08 08 08 09 14 14 14 14 14 14 14 14 14 14 14 14 46 14 14 46 14 14 14 42 14 14 14 14 14 14 14 14 14 14 46 14 14 46 14 14 14 14 14 14 14 14 14 14 14 14 14 14 46 14 14 46 14 14 14 14 14 14 43 14 14 14 14 14 07 08 08 08 08 08 08 08 08 08 08 08 08 08 08 08 08 08 08 08 08 08 08 46 14 14 14 14 14 14 14 14 14 14 14 14 14 14 46 14 15 17 14 14 14 14 14 14 43 14 14 14 14 14 14 14 14 14 14 14 14 43 14 14 14 14 14 14 14 14 14 14 14 07 08 08 08
08 08 08 09 08 08 08 08 08 08 08 08 08 08 09 14 14 14 14 14 14 14 14 14 14 14 14 45 14 14 45 14 14 14 43 14 14 14 14 14 14 14 14 14 14 45 14 14 45 14 14 14 14 14 14 14 14 14 14 14 14 14 14 45 14 14 45 14 14 14 14 14 14 44 14 14 14 14 14 07 08 08 08 08 08 08 08 08 08 08 08 08 08 08 08 08 08 08 08 08 08 08 45 14 14 14 14 14 14 14 14 14 14 14 14 14 14 45 14 15 17 14 14 14 14 14 14 44 14 14 14 14 14 14 14 14 14 14 14 14 44 14 14 14 14 14 14 14 14 14 14 14 07 08 08 08
08 08 08 09 08 08 08 08 08 08 08 08 08 08 09 14 14 14 14 14 14 14 42 14 14 14 14 46 14 14 46 14 14 14 44 14 14 14 14 14 14 14 14 14 14 46 14 14 46 14 14 14 14 14 14 14 42 14 14 14 14 14 14 46 14 14 46 14 14 14 14 14 14 14 14 14 14 14 14 07 08 08 08 08 08 08 08 08 08 08 08 08 08 08 08 08 08 08 08 08 08 08 46 14 14 14 14 14 14 14 14 14 14 14 14 14 14 46 14 15 17 14 14 14 14 14 14 14 14 14 14 14 14 14 14 14 14 14 14 14 14 14 14 14 14 14 14 14 14 14 14 14 07 08 08 08
08 08 08 09 08 08 08 08 08 08 08 08 08 08 09 14 14 14 14 14 14 14 43 14 14 14 18 19 20 21 22 23 14 14 14 14 14 14 14 14 14 14 14 14 18 19 20 21 22 23 14 14 14 14 14 14 43 14 14 14 14 14 18 19 20 21 22 23 14 14 14 14 14 14 14 14 14 14 14 07 08 08 08 08 08 08 08 08 08 08 08 08 08 08 08 08 08 08 08 08 08 08 22 23 14 14 14 14 14 14 14 14 14 14 14 14 18 19 20 15 17 14 14 14 14 14 14 14 14 14 14 14 14 14 14 14 14 14 14 14 14 14 14 14 14 14 14 14 14 14 14 14 07 08 08 08 
08 08 08 09 08 08 08 08 08 08 08 08 08 08 09 14 14 14 14 14 14 14 44 14 14 14 24 25 26 27 28 29 14 14 14 14 14 14 14 14 14 14 14 14 24 25 26 27 28 29 14 14 14 14 14 14 44 14 14 14 14 14 24 25 26 27 28 29 14 14 14 14 14 14 14 14 14 14 14 07 08 08 08 08 08 08 08 08 08 08 08 08 08 08 08 08 08 08 08 08 08 08 28 29 14 14 14 14 14 14 14 14 14 14 14 14 24 25 26 15 17 14 14 14 14 14 14 14 14 14 14 14 14 14 14 14 14 14 14 14 14 14 14 14 14 14 14 14 14 14 14 14 07 08 08 08 
08 08 08 09 08 08 08 08 08 08 08 08 08 08 09 14 14 14 14 14 14 14 14 14 14 14 30 31 32 33 34 35 14 14 14 14 14 14 14 14 14 14 14 14 30 31 32 33 34 35 14 14 14 14 14 14 14 14 14 14 14 14 30 31 32 33 34 35 14 14 14 14 14 14 14 14 14 14 14 07 08 08 08 08 08 08 08 08 08 08 08 08 08 08 08 08 08 08 08 08 08 08 34 35 14 14 14 14 14 14 14 14 14 14 14 14 30 31 32 15 17 14 14 14 14 14 14 14 14 14 14 14 14 14 14 14 14 14 14 14 14 14 14 14 14 14 14 14 14 14 14 14 07 08 08 08
08 08 08 09 08 08 08 08 08 08 08 08 08 08 09 14 14 14 14 14 14 14 14 14 14 14 36 37 38 39 40 41 14 14 14 14 14 14 14 14 42 14 14 14 36 37 38 39 40 41 14 14 14 14 14 14 14 14 14 14 14 14 36 37 38 39 40 41 14 14 14 14 14 14 14 14 14 14 14 07 08 08 08 08 08 08 08 08 08 08 08 08 08 08 08 08 08 08 08 08 08 08 40 41 14 14 14 14 14 14 14 14 14 14 14 14 36 37 38 15 17 14 14 14 14 14 14 14 14 14 14 14 14 14 14 14 14 14 14 14 14 14 14 14 42 14 14 14 14 14 14 14 07 08 08 08 
08 08 08 09 08 08 08 08 08 08 08 08 08 08 09 14 14 14 14 14 14 14 14 14 14 14 14 46 14 14 46 14 14 14 14 14 14 14 14 14 43 14 14 14 14 46 14 14 46 14 14 14 14 14 14 14 14 14 14 14 14 14 14 46 14 14 46 14 14 14 14 14 14 14 14 14 14 14 14 07 08 08 08 08 08 08 08 08 08 08 08 08 08 08 08 08 08 08 08 08 08 08 46 14 14 14 14 14 14 14 14 42 14 14 14 14 14 46 14 14 47 14 14 14 14 14 14 14 14 14 14 14 14 14 14 14 14 14 14 14 14 14 14 14 43 14 14 14 14 14 14 14 07 08 08 08 
08 08 08 09 08 08 08 08 08 08 08 08 08 08 09 14 14 14 14 14 14 14 14 14 14 14 14 45 14 14 45 14 14 14 14 14 49 02 02 02 02 02 03 14 14 45 14 14 45 14 14 14 14 14 14 14 14 14 14 14 14 14 14 45 14 14 45 14 14 14 14 14 14 14 14 14 14 14 14 07 08 08 08 08 08 08 08 08 08 08 08 08 08 08 08 08 08 08 08 08 08 08 45 14 14 14 14 14 14 14 14 43 14 14 14 14 14 45 14 14 48 14 14 14 14 14 14 14 14 14 14 14 14 14 14 14 14 14 14 14 14 14 14 14 44 14 14 14 14 14 14 14 07 08 08 08
08 08 08 09 08 08 08 08 08 08 08 08 08 08 08 02 02 02 02 02 02 02 02 03 14 14 14 46 14 14 46 14 14 14 14 14 50 05 05 05 05 05 06 14 14 46 14 14 46 14 14 14 14 14 14 14 14 14 14 14 14 14 14 46 14 14 46 14 14 14 14 14 14 14 14 14 14 14 14 07 08 08 08 08 08 08 08 08 08 08 08 08 08 08 08 08 08 08 08 08 08 08 46 14 14 14 14 14 14 14 14 44 14 14 14 14 14 46 14 14 47 14 14 14 14 14 14 14 14 14 14 14 14 14 14 14 14 14 14 14 14 14 14 14 14 14 14 14 14 14 14 14 07 08 08 08
08 08 08 09 08 08 08 08 08 08 08 08 08 08 08 05 05 05 05 05 05 05 05 06 14 14 14 46 14 14 46 14 14 14 14 14 07 08 08 08 08 08 09 14 14 46 14 14 46 14 14 49 02 02 02 02 02 02 02 02 02 02 02 02 02 02 02 02 02 02 02 03 14 14 14 14 14 14 14 07 08 08 08 08 08 08 08 08 08 08 08 08 08 08 08 08 08 08 08 08 08 08 46 14 14 14 14 14 14 14 14 14 14 14 14 14 14 46 14 14 48 14 14 14 14 14 14 14 14 14 14 14 14 14 14 14 14 14 14 14 14 14 14 14 14 14 14 14 14 14 14 14 07 08 08 08
08 08 08 08 08 08 08 08 08 08 08 08 08 08 08 08 08 08 08 08 08 08 08 09 14 14 14 46 14 14 46 50 05 05 05 05 08 08 08 08 08 08 08 05 05 05 05 05 05 05 05 05 05 05 05 05 05 05 05 05 05 05 05 05 05 05 05 05 05 05 05 05 05 05 05 05 05 05 05 08 08 08 08 08 08 08 08 08 08 08 08 08 08 08 08 08 08 08 08 08 08 08 05 05 05 05 05 05 05 05 05 05 05 05 05 05 05 05 05 05 05 05 05 05 05 05 05 05 05 05 05 05 05 05 05 05 05 05 05 05 05 05 05 05 05 05 05 05 05 05 05 05 08 08 08 08 
08 08 08 08 08 08 08 08 08 08 08 08 08 08 08 08 08 08 08 08 08 08 08 09 14 14 14 46 14 14 46 07 08 08 08 08 08 08 08 08 08 08 08 08 08 08 08 08 08 08 08 08 08 08 08 08 08 08 08 08 08 08 08 08 08 08 08 08 08 08 08 08 08 08 08 08 08 08 08 08 08 08 08 08 08 08 08 08 08 08 08 08 08 08 08 08 08 08 08 08 08 08 08 08 08 08 08 08 08 08 08 08 08 08 08 08 08 08 08 08 08 08 08 08 08 08 08 08 08 08 08 08 08 08 08 08 08 08 08 08 08 08 08 08 08 08 08 08 08 08 08 08 08 08 08 08
08 08 08 08 08 08 08 08 08 08 08 08 08 08 08 08 08 08 08 08 08 08 08 08 05 05 05 05 05 05 05 08 08 08 08 08 08 08 08 08 08 08 08 08 08 08 08 08 08 08 08 08 08 08 08 08 08 08 08 08 08 08 08 08 08 08 08 08 08 08 08 08 08 08 08 08 08 08 08 08 08 08 08 08 08 08 08 08 08 08 08 08 08 08 08 08 08 08 08 08 08 08 08 08 08 08 08 08 08 08 08 08 08 08 08 08 08 08 08 08 08 08 08 08 08 08 08 08 08 08 08 08 08 08 08 08 08 08 08 08 08 08 08 08 08 08 08 08 08 08 08 08 08 08 08 08   
08 08 08 08 08 08 08 08 08 08 08 08 08 08 08 08 08 08 08 08 08 08 08 08 08 08 08 08 08 08 08 08 08 08 08 08 08 08 08 08 08 08 08 08 08 08 08 08 08 08 08 08 08 08 08 08 08 08 08 08 08 08 08 08 08 08 08 08 08 08 08 08 08 08 08 08 08 08 08 08 08 08 08 08 08 08 08 08 08 08 08 08 08 08 08 08 08 08 08 08 08 08 08 08 08 08 08 08 08 08 08 08 08 08 08 08 08 08 08 08 08 08 08 08 08 08 08 08 08 08 08 08 08 08 08 08 08 08 08 08 08 08 08 08 08 08 08 08 08 08 08 08 08 08 08 08
08 08 08 08 08 08 08 08 08 08 08 08 08 08 08 08 08 08 08 08 08 08 08 08 08 08 08 08 08 08 08 08 08 08 08 08 08 08 08 08 08 08 08 08 08 08 08 08 08 08 08 08 08 08 08 08 08 08 08 08 08 08 08 08 08 08 08 08 08 08 08 08 08 08 08 08 08 08 08 08 08 08 08 08 08 08 08 08 08 08 08 08 08 08 08 08 08 08 08 08 08 08 08 08 08 08 08 08 08 08 08 08 08 08 08 08 08 08 08 08 08 08 08 08 08 08 08 08 08 08 08 08 08 08 08 08 08 08 08 08 08 08 08 08 08 08 08 08 08 08 08 08 08 08 08 08
08 08 08 08 08 08 08 08 08 08 08 08 08 08 08 08 08 08 08 08 08 08 08 08 08 08 08 08 08 08 08 08 08 08 08 08 08 08 08 08 08 08 08 08 08 08 08 08 08 08 08 08 08 08 08 08 08 08 08 08 08 08 08 08 08 08 08 08 08 08 08 08 08 08 08 08 08 08 08 08 08 08 08 08 08 08 08 08 08 08 08 08 08 08 08 08 08 08 08 08 08 08 08 08 08 08 08 08 08 08 08 08 08 08 08 08 08 08 08 08 08 08 08 08 08 08 08 08 08 08 08 08 08 08 08 08 08 08 08 08 08 08 08 08 08 08 08 08 08 08 08 08 08 08 08 08
08 08 08 08 08 08 08 08 08 08 08 08 08 08 08 08 08 08 08 08 08 08 08 08 08 08 08 08 08 08 08 08 08 08 08 08 08 08 08 08 08 08 08 08 08 08 08 08 08 08 08 08 08 08 08 08 08 08 08 08 08 08 08 08 08 08 08 08 08 08 08 08 08 08 08 08 08 08 08 08 08 08 08 08 08 08 08 08 08 08 08 08 08 08 08 08 08 08 08 08 08 08 08 08 08 08 08 08 08 08 08 08 08 08 08 08 08 08 08 08 08 08 08 08 08 08 08 08 08 08 08 08 08 08 08 08 08 08 08 08 08 08 08 08 08 08 08 08 08 08 08 08 08 08 08 08